iteration,numberOfWalkDecisions,NumberOfBicycleDecisions,NumberOfPassesDueToTopography,NumberOfPassesDueToRandom,NumberOfPassesDueToNoInfra
1,899490,510,32474,0,867016
2,899503,497,37302,0,862201
3,899509,491,39104,0,860405
4,899516,484,40812,0,858704
5,899470,530,36872,0,862598
6,899462,538,46389,0,853073
7,899523,477,31453,0,868070
8,899525,475,38611,0,860914
9,899452,548,39311,0,860141
10,899471,529,40527,0,858944
